start = 0,5
exit = 9,13
NR_COLUMNS = 20
NR_ROWS = 10

----- --------------
|   |    |--       |
|    --  -    |    |
|             |    |
|    |-- -- --|    |
|             |    |
|    -----         |
|        |    |    |
|    |   |         |
------------- ------